%%%%%%%%%%%%%%%%%
%    .         .%
%      .   .    %
%   %%%%%      .%
%PG     %.      %
%       %%%     %
%        .     .%
%%%%%%%%%%%%%%%%%
